R 1920 1080
NO ./textures/cat1.xpm
SO ./textures/cat2.xpm
WE ./textures/cat3.xpm
EA ./textures/cat4.xpm
S ./textures/barrel.xpm
F 0,80,0
C 0,206,209

        1111111111111111111111111
        1000000000110000000000001
        1011020001110000002000001
        1001220W00000000000000001
111111111011220001110000000000001
100000000011000001110111111111111
11110111111111011100000010001
11110111111111011101010010001
11000000110101011100000010001
100020000000000011000000100011
1000000000000000000101000000001
1100000111010101111101111000111
11110111 1110101 101111010001
11111111 1111111 111111111111